1
1111111111111111111111111111111111111111111111111111111111111111111111111111111111111111111111111111
1000000000000000000000000000000000000000000000000000000000000000000000000000000000000000000000000001
1000000000000000000000000000000000000000000000000000000000000000000000000000000000000000000000000001
1000000000000000000000000000000000000000000000000000000000000000000000000000000000000000000000000001
1000000000000000000000000000000000000000000000000000000000000000000000000000000000000000000000000001
1000000000000000000000000000000000000000000000000000000000000000000000000000000000000000000000000001
1000000000000000000000000000000000000000000000000000000000000000000000000000000000000000000000000001
1000000000000000000000000000000000000000000000000000000000000000000000000000000000000000000000000001
1000000000000000000000000000000000000000000000000000000000000000000000000000000000000000000000000001
1000000000000000000000000000000000000000000000000000000000000000000000000000000000000000000000000001
1000000000000000000000000000000000000000000000000000000000000000000000000000000000000000000000000001
1000000000000000000000000000000000000000000000000000000000000000000000000000000000000000000000000001
1000000000000000000000000000000000000000000000000000000000000000000000000000000000000000000000000001
1000000000000000000000000000000000000000000000000000000000000000000000000000000000000000000000000001
1000000000000000000000000000000011000000000000000000000000000000001100000000000000000000000000000001
1000000000000000000000000000000011000000000000000000000000000000001100000000000000000000000000000001
1000000000000000000000000000000011000000000000000000000000000000001100000000000000000000000000000001
1000000000000000000000000000000011000000000000000000000000000000001100000000000000000000000000000001
1000000000000000000000000000000011000000000000000000000000000000001100000000000000000000000000000001
1000000000000000000000000000000011000000000000000000000000000000001100000000000000000000000000000001
1000000000000000000000000000000011000000000000000000000000000000001100000000000000000000000000000001
1000000000000000000000000000000011000000000000000000000000000000001100000000000000000000000000000001
1000000000000000000000000000000011000000000000000000000000000000001100000000000000000000000000000001
1000000000000000000000000000000011000000000000000000000000000000001100000000000000000000000000000001
1000000000000000000000000000000011000000000000000000000000000000001100000000000000000000000000000001
1000000000000000000000000000000011000000000000000000000000000000001100000000000000000000000000000001
1000000000000000000000000000000011000000000000000000000000000000001100000000000000000000000000000001
1000000000000000000000000000000011000000000000000000000000000000001100000000000000000000000000000001
1000000000000000000000000000000011000000000000000000000000000000001100000000000000000000000000000001
1000000000000000000000000000000011000000000000000000000000000000001100000000000000000000000000000001
1000000000000000000000000000000011000000000000000000000000000000001100000000000000000000000000000001
1000000000000000000000000000000011000000000000000000000000000000001100000000000000000000000000000001
1000000000000000000000000000000011000000000000000000000000000000001100000000000000000000000000000001
1000000000000000000000000000000011000000000000000000000000000000001100000000000000000000000000000001
1000000000000000000000000000000011000000000000000000000000000000001100000000000000000000000000000001
1000000000000000000000000000000011000000000000000000000000000000001100000000000000000000000000000001
1000000000000000000000000000000011000000000000000000000000000000001100000000000000000000000000000001
1000000000000000000000000000000011111111111111111111111111111111111100000000000000000000000000000001
1000000000000000000000000000000000000000000000000000000000000000001100000000000000000000000000000001
1000000000000000000000000000000000000000000000000000000000000000000000000000000000000000000000000001
1000000000000000000000000000000000000000000000000000000000000000000000000000000000000000000000000001
1000000000000000000000000000000000000000000000000000000000000000000000000000000000000000000000000001
1000000000000000000000000000000000000000000000000000000000000000000000000000000000000000000000000001
1000000000000000000000000000000000000000000000000000000000000000000000000000000000000000000000000001
1000000000000000000000000000000000000000000000000000000000000000000000000000000000000000000000000001
1000000000000000000000000000000000000000000000000000000000000000000000000000000000000000000000000001
1000000000000000000000000000000000000000000000000000000000000000000000000000000000000000000000000001
1000000000000000000000000000000000000000000000000000000000000000000000000000000000000000000000000001
1000000000000000000000000000000000000000000000000000000000000000000000000000000000000000000000000001
1000000000000000000000000000000000000000000000000000000000000000000000000000000000000000000000000001
1000000000000000000000000000000000000000000000000000000000000000000000000000000000000000000000000001
1000000000000000000000000000000000000000000000000000000000000000000000000000000000000000000000000001
1000000000000000000000000000000000000000000000000000000000000000000000000000000000000000000000000001
1000000000000000000000000000000000000000000000000000000000000000000000000000000000000000000000000001
1000000000000000000000000000000000000000000000000000000000000000000000000000000000000000000000000001
1000000000000000000000000000000000000000000000000000000000000000000000000000000000000000000000000001
1000000000000000000000000000000000000000000000000000000000000000000000000000000000000000000000000001
1000000000000000000000000000000000000000000000000000000000000000000000000000000000000000000000000001
1000000000000000000000000000000000000000000000000000000000000000000000000000000000000000000000000001
1000000000000000000000000000000000000000000000000000000000000000000000000000000000000000000000000001
1000000000000000000000000000000000000000000000000000000000000000000000000000000000000000000000000001
1000000000000000000000000000000000000000000000000000000000000000000000000000000000000000000000000001
1000000000000000000000000000000000000000000000000000000000000000000000000000000000000000000000000001
1000000000000000000000000000000011000000000000000000000000000000001100000000000000000000000000000001
1000000000000000000000000000000011000000000000000000000000000000001100000000000000000000000000000001
1000000000000000000000000000000011000000000000000000000000000000001100000000000000000000000000000001
1000000000000000000000000000000011000000000000000000000000000000001100000000000000000000000000000001
1000000000000000000000000000000011000000000000000000000000000000001100000000000000000000000000000001
1000000000000000000000000000000011000000000000000000000000000000001100000000000000000000000000000001
1000000000000000000000000000000011000000000000000000000000000000001100000000000000000000000000000001
1000000000000000000000000000000011000000000000000000000000000000001100000000000000000000000000000001
1000000000000000000000000000000011000000000000000000000000000000001100000000000000000000000000000001
1000000000000000000000000000000011000000000000000000000000000000001100000000000000000000000000000001
1000000000000000000000000000000011000000000000000000000000000000001100000000000000000000000000000001
1000000000000000000000000000000011000000000000000000000000000000001100000000000000000000000000000001
1000000000000000000000000000000011000000000000000000000000000000001100000000000000000000000000000001
1000000000000000000000000000000011000000000000000000000000000000001100000000000000000000000000000001
1000000000000000000000000000000011000000000000000000000000000000001100000000000000000000000000000001
1000000000000000000000000000000011000000000000000000000000000000001100000000000000000000000000000001
1000000000000000000000000000000011000000000000000000000000000000001100000000000000000000000000000001
1000000000000000000000000000000011000000000000000000000000000000001100000000000000000000000000000001
1000000000000000000000000000000011000000000000000000000000000000001100000000000000000000000000000001
1000000000000000000000000000000011000000000000000000000000000000001100000000000000000000000000000001
1000000000000000000000000000000011000000000000000000000000000000001100000000000000000000000000000001
1000000000000000000000000000000011000000000000000000000000000000001100000000000000000000000000000001
1000000000000000000000000000000001000000000000000000000000000000001100000000000000000000000000000001
1000000000000000000000000000000011111111111111111111111111111111111100000000000000000000000000000001
1000000000000000000000000000000001000100000001000000000000000000001100000000000000000000000000000001
1000000000000000000000000000000000000000000000000000000000000000000000000000000000000000000000000001
1000000000000000000000000000000000000000000000000000000000000000000000000000000000000000000000000001
1000000000000000000000000000000000000000000000000000000000000000000000000000000000000000000000000001
1000000000000000000000000000000000000000000000000000000000000000000000000000000000000000000000000001
1000000000000000000000000000000000000000000000000000000000000000000000000000000000000000000000000001
1000000000000000000000000000000000000000000000000000000000000000000000000000000000000000000000000001
1000000000000000000000000000000000000000000000000000000000000000000000000000000000000000000000000001
1000000000000000000000000000000000000000000000000000000000000000000000000000000000000000000000000001
1000000000000000000000000000000000000000000000000000000000000000000000000000000000000000000000000001
1000000000000000000000000000000000000000000000000000000000000000000000000000000000000000000000000001
1000000000000000000000000000000000000000000000000000000000000000000000000000000000000000000000000001
1111111111111111111111111111111111111111111111111111111111111111111111111111111111111111111111111111
